

The '''Asian Football Confederation''' often referred to as just '''AFC''', is the organization that controls Asian football (soccer)|football.

Regions
The AFC has 46 member associations split into four regions.




=ASEAN Football Federation=


 Football Federation of Australia|Australia
 National Football Association of Brunei Darussalam|Brunei
 Cambodian Football Federation|Cambodia
 Football Association of Indonesia|Indonesia
 Lao Football Federation|Laos
 Football Association of Malaysia|Malaysia
 Myanmar Football Federation|Myanmar
 Philippine Football Federation|Philippines
 Football Association of Singapore|Singapore
 Football Association of Thailand|Thailand
 Federação de Futebol de Timor-Leste|Timor-Leste
 Vietnam Football Federation|Vietnam



=East Asian Football Federation=


 China Football Association|China PR
 Guam Football Association|Guam
 Hong Kong Football Association|Hong Kong
 Japan Football Association|Japan
 DPR Korea Football Association|Korea DPR
 Korea Football Association|Korea Republic
 Macau Football Association|Macau
 Mongolian Football Federation|Mongolia
 Chinese Taipei Football Association|Chinese Taipei


=Central and South Asian Football Federation=


SAFF Members
 Afghanistan Football Federation|Afghanistan
 Bangladesh Football Federation|Bangladesh
 Bhutan Football Federation|Bhutan
 All India Football Federation|India
 Football Association of Maldives|Maldives
 All Nepal Football Association|Nepal
 Pakistan Football Federation|Pakistan
 Football Federation of Sri Lanka|Sri Lanka

CAFF Members
 Football Federation of Kyrgyz Republic|Kyrgyzstan
 Tajikistan National Football Federation|Tajikistan
 Football Association of Turkmenistan|Turkmenistan
 Uzbekistan Football Federation|Uzbekistan



=West Asian Football Federation=


 Football Federation Islamic Republic of Iran|Iran
 Iraq Football Association|Iraq
 Saudi Arabia Football Federation|Saudi Arabia
 Bahrain Football Association|Bahrain
 Jordan Football Association|Jordan
 Kuwait Football Association|Kuwait
 Lebanese Football Association|Lebanon
 Oman Football Association|Oman
 Palestinian Football Federation|Palestine
 Qatar Football Association|Qatar
 Syrian Arab Federation for Football|Syria
 United Arab Emirates Football Association|United Arab Emirates
 Yemen Football Association|Yemen



Related pages
 AFC Asian Cup
 AFC Champions League

 Other websites 
 



Category:Asian Football Confederation
Category:1954 establishments in Asia
Category:Sports organizations of Asia