

'''Line 9''' ('''''Línia 9''''' in Catalan language|Catalan) is the newest line in the Barcelona Metro network, currently under construction, with only five complete stations, all in Santa Coloma de Gramenet. These first five stations opened on 13 December 2009. The complete line is a railway projectA.a.v.v. Institut d'Estudis Catalans, 2006: ''Anuari territorial de Catalunya 2005.''  to build a subway line with two branches spanning a good deal of the metropolitan area of Barcelona through Barcelona, Santa Coloma de Gramenet, Badalona, l'Hospitalet de Llobregat and El Prat de Llobregat. Transports Metropolitans de Barcelona|TMB is the company operating the line and handled by the division line in two: Line 9 and L10|Line 10.




 List of stations 
(''Keep in mind all of them are currently under construction'')

'''El Prat area'''
 Aeroport-T1(Barcelona Metro)|Aeroport-T1 (Barcelona International Airport, RENFE)
 Ciutat Aeroportuària (Barcelona Metro)|Ciutat Aeroportuària
 Aeroport-T2 (Barcelona Metro)|Aeroport-T2 (Barcelona International Airport, RENFE)
 Mas Blau (Barcelona Metro)|Mas Blau
 Sant Cosme (Barcelona Metro)|Sant Cosme
 El Prat Centre (Barcelona Metro)|El Prat
 Estació del Prat (Barcelona Metro)|Estació del Prat (Barcelona metro line 1|L1, RENFE)
 Centre Direccional (Barcelona Metro)|Centre Direccional
 Verge de Montserrat (Barcelona Metro)|Verge de Montserrat
 Mercabarna (Barcelona Metro)|Mercabarna
 Parc Logístic (Barcelona Metro)|Parc Logístic
 Fira 2-Pedrosa (Barcelona Metro)|Fira 2-Pedrosa (Barcelona metro line 2|L2)
 Europa-Fira (Barcelona Metro)|Europa-Fira (Barcelona metro line 8|L8)
'''Central branch, shared with L10'''
 Can Tries (Barcelona Metro)|Can Tries
 Torrassa (Barcelona Metro)|Torrassa (Barcelona metro line 1|L1, RENFE)
 Collblanc (Barcelona Metro)|Collblanc (Barcelona metro line 5|L5)
 Campus Sud (Barcelona Metro)|Campus Sud (Trambesòs route 1|T1, Trambesòs route 2|T2, Trambesòs route 3|T3)
 Zona Universitària (Barcelona Metro)|Zona Universitària (Barcelona metro line 3|L3)
 Campus Nord (Barcelona Metro)|Campus Nord
 Manuel Girona (Barcelona Metro)|Manuel Girona
 Prat de la Riba (Barcelona Metro)|Prat de la Riba
 Sarrià (Barcelona Metro)|Sarrià (Barcelona metro line 6|L6)
 Mandrí (Barcelona Metro)|Mandrí
 El Putxet (Barcelona Metro)|El Putxet (Barcelona metro line 7|L7)
 Lesseps (Barcelona Metro)|Lesseps (Barcelona metro line 3|L3)
 Muntanya (Barcelona Metro)|Muntanya
 Sanllehy (Barcelona Metro)|Sanllehy
 Guinardó (Barcelona Metro)|Guinardó (Barcelona metro line 4|L4)
 Maragall (Barcelona Metro)|Maragall
 Sagrera-Meridiana (Barcelona Metro)|Sagrera-Meridiana (Barcelona metro line 1|L1, Barcelona metro line 4|L4, RENFE)
 Estació de la Sagrera metro staton|Estació de la Sagrera (Barcelona metro line 4|L4, RENFE-AVE)
 Onze de Setembre (Barcelona Metro)|Onze de Setembre
 Bon Pastor (Barcelona Metro)|Bon Pastor
'''Besòs area'''
 Can Peixauet (Barcelona Metro)|Can Peixauet
 Santa Rosa (Barcelona Metro)|Santa Rosa
 Fondo (Barcelona Metro)|Fondo (Barcelona metro line 1|L1)
 Església Major (Barcelona Metro)|Església Major
 Singuerlín (Barcelona Metro)|Singuerlín
 Can Zam (Barcelona Metro)|Can Zam

Category:Barcelona Metro lines|9