This is a list of the 43 '''cantons of France|cantons of the Ain departments of France|department''', in France, by arrondissement:

Arrondissement of Belley (9 cantons)
 Canton of Ambérieu-en-Bugey|Ambérieu-en-Bugey
 Canton of Belley|Belley
 Canton of Champagne-en-Valromey|Champagne-en-Valromey
 Canton of Hauteville-Lompnes|Hauteville-Lompnes
 Canton of Lagnieu|Lagnieu
 Canton of Lhuis|Lhuis
 Canton of Saint-Rambert-en-Bugey|Saint-Rambert-en-Bugey
 Canton of Seyssel (Ain)|Seyssel
 Canton of Virieu-le-Grand|Virieu-le-Grand

Arrondissement of Bourg-en-Bresse (24 cantons)
 Canton of Bâgé-le-Châtel|Bâgé-le-Châtel
 Canton of Bourg-en-Bresse-Est|Bourg-en-Bresse-Est
 Canton of Bourg-en-Bresse-Nord-Centre|Bourg-en-Bresse-Nord-Centre
 Canton of Bourg-en-Bresse-Sud|Bourg-en-Bresse-Sud
 Canton of Ceyzériat|Ceyzériat
 Canton of Chalamont|Chalamont
 Canton of Châtillon-sur-Chalaronne|Châtillon-sur-Chalaronne
 Canton of Coligny|Coligny
 Canton of Meximieux|Meximieux
 Canton of Miribel|Miribel
 Canton of Montluel|Montluel
 Canton of Montrevel-en-Bresse|Montrevel-en-Bresse
 Canton of Péronnas|Péronnas
 Canton of Pont-d'Ain|Pont-d'Ain
 Canton of Pont-de-Vaux|Pont-de-Vaux
 Canton of Pont-de-Veyle|Pont-de-Veyle
 Canton of Reyrieux|Reyrieux
 Canton of Saint-Trivier-de-Courtes|Saint-Trivier-de-Courtes
 Canton of Saint-Trivier-sur-Moignans|Saint-Trivier-sur-Moignans
 Canton of Thoissey|Thoissey
 Canton of Treffort-Cuisiat|Treffort-Cuisiat
 Canton of Trévoux|Trévoux
 Canton of Villars-les-Dombes|Villars-les-Dombes
 Canton of Viriat|Viriat

Arrondissement of Gex (3 cantons)
 Canton of Collonges|Collonges
 Canton of Ferney-Voltaire|Ferney-Voltaire
 Canton of Gex|Gex

Arrondissement of Nantua (7 cantons)
 Canton of Bellegarde-sur-Valserine|Bellegarde-sur-Valserine
 Canton of Brénod|Brénod
 Canton of Izernore|Izernore
 Canton of Nantua|Nantua
 Canton of Oyonnax-Nord|Oyonnax-Nord
 Canton of Oyonnax-Sud|Oyonnax-Sud
 Canton of Poncin|Poncin

Category:France-related lists
Category:Auvergne-Rhône-Alpes
Category:Cantons of France|Ain department