
The Switzerland|Swiss '''canton of Bern''' has about 947,000 people. The Cantons of Switzerland|canton is in west-central Switzerland and the city of Bern (city)|Bern is its capital.

 Districts 
As of 2004|As of April 2004, there are 398 municipalities of the canton of Bern within the following 26 administrative districts:

 Aarberg (district)|Aarberg with capital Aarberg
 Aarwangen (district)|Aarwangen with capital Aarwangen
 Bern (district)|Bern with capital Berne
 Biel (district)|Biel with capital Biel
 Büren (district)|Büren with capital Büren an der Aare
 Burgdorf (district)|Burgdorf with capital Burgdorf, Switzerland|Burgdorf
 Courtelary (district)|Courtelary with capital Courtelary
 Erlach (district)|Erlach with capital Erlach, Switzerland|Erlach
 Fraubrunnen (district)|Fraubrunnen with capital Fraubrunnen
 Frutigen (district)|Frutigen with capital Frutigen
 Interlaken (district)|Interlaken with capital Interlaken
 Konolfingen (district)|Konolfingen with capital Konolfingen
 Laupen (district)|Laupen with capital Laupen, Bern|Laupen
 Moutier (district)|Moutier with capital Moutier
 La Neuveville (district)|La Neuveville with capital La Neuveville
 Nidau (district)|Nidau with capital Nidau
 Niedersimmental (district)|Niedersimmental with capital Wimmis
 Oberhasli (district)|Oberhasli with capital Meiringen
 Obersimmental (district)|Obersimmental with capital Zweisimmen|Blankenburg
 Saanen (district)|Saanen with capital Saanen
 Schwarzenburg (district)|Schwarzenburg with capital Schwarzenburg
 Seftigen (district)|Seftigen with capital Belp
 Signau (district)|Signau with capital Langnau im Emmental
 Thun (district)|Thun with capital Thun
 Trachselwald (district)|Trachselwald with capital Trachselwald
 Wangen (district)|Wangen with capital Wangen an der Aare

 Other websites 

     


Category:Canton of Bern| 