
This is a list of the 42 '''cantons of France|cantons of the Aisne departments of France|department''', in France, by arrondissement:

 Arrondissement of Château-Thierry (5 cantons) 
 Canton of Charly-sur-Marne|Charly-sur-Marne
 Canton of Château-Thierry|Château-Thierry
 Canton of Condé-en-Brie|Condé-en-Brie
 Canton of Fère-en-Tardenois|Fère-en-Tardenois
 Canton of Neuilly-Saint-Front|Neuilly-Saint-Front

 Arrondissement of Laon (13 cantons) 
 Canton of Anizy-le-Château|Anizy-le-Château
 Canton of Chauny|Chauny
 Canton of Coucy-le-Château-Auffrique|Coucy-le-Château-Auffrique
 Canton of Craonne|Craonne
 Canton of Crécy-sur-Serre|Crécy-sur-Serre
 Canton of La Fère|La Fère
 Canton of Laon-Nord|Laon-Nord
 Canton of Laon-Sud|Laon-Sud
 Canton of Marle|Marle
 Canton of Neufchâtel-sur-Aisne|Neufchâtel-sur-Aisne
 Canton of Rozoy-sur-Serre|Rozoy-sur-Serre
 Canton of Sissonne|Sissonne
 Canton of Tergnier|Tergnier

 Arrondissement of Saint-Quentin (9 cantons) 
 Canton of Bohain-en-Vermandois|Bohain-en-Vermandois
 Canton of Le Catelet|Le Catelet
 Canton of Moÿ-de-l'Aisne|Moÿ-de-l'Aisne
 Canton of Ribemont|Ribemont
 Canton of Saint-Quentin-Centre|Saint-Quentin-Centre
 Canton of Saint-Quentin-Nord|Saint-Quentin-Nord
 Canton of Saint-Quentin-Sud|Saint-Quentin-Sud
 Canton of Saint-Simon|Saint-Simon
 Canton of Vermand|Vermand

 Arrondissement of Soissons (7 cantons) 
 Canton of Braine|Braine
 Canton of Oulchy-le-Château|Oulchy-le-Château
 Canton of Soissons-Nord|Soissons-Nord
 Canton of Soissons-Sud|Soissons-Sud
 Canton of Vailly-sur-Aisne|Vailly-sur-Aisne
 Canton of Vic-sur-Aisne|Vic-sur-Aisne
 Canton of Villers-Cotterêts|Villers-Cotterêts

 Arrondissement of Vervins (8 cantons) 
 Canton of Aubenton|Aubenton
 Canton of La Capelle|La Capelle
 Canton of Guise|Guise
 Canton of Hirson|Hirson
 Canton of Le Nouvion-en-Thiérache|Le Nouvion-en-Thiérache
 Canton of Sains-Richaumont|Sains-Richaumont
 Canton of Vervins|Vervins
 Canton of Wassigny|Wassigny

Category:France-related lists
Category:Hauts-de-France
Category:Cantons of France|Aisne department