
This is a list of lists of colleges and university|universities in the United States:

 Northeast 

 Colleges and universities in Connecticut|Connecticut
 Colleges and universities in Delaware|Delaware
 Colleges and universities in Maine|Maine
 Colleges and universities in Massachusetts|Massachusetts
 Colleges and universities in New Hampshire|New Hampshire
 Colleges and universities in New Jersey|New Jersey
 Colleges and universities in New York|New York
 Colleges and universities in Pennsylvania|Pennsylvania
 Colleges and universities in Rhode Island|Rhode Island
 Colleges and universities in Vermont|Vermont

 Midwest 

 Colleges and universities in Illinois|Illinois
 Colleges and universities in Indiana|Indiana
 Colleges and universities in Iowa|Iowa
 Colleges and universities in Kansas|Kansas
 Colleges and universities in Michigan|Michigan
 Colleges and universities in Minnesota|Minnesota
 Colleges and universities in Missouri|Missouri
 Colleges and universities in Nebraska|Nebraska
 Colleges and universities in North Dakota|North Dakota
 Colleges and universities in Ohio|Ohio
 Colleges and universities in South Dakota|South Dakota
 Colleges and universities in Wisconsin|Wisconsin

 South 
 
 Colleges and universities in Alabama|Alabama
 
 Colleges and universities in Arkansas|Arkansas
 Colleges and universities in the District of Columbia|District of Columbia
 Colleges and universities in Florida|Florida
 Colleges and universities in Georgia (U.S. state)|Georgia
 Colleges and universities in Kentucky|Kentucky
 Colleges and universities in Louisiana|Louisiana
 Colleges and universities in Maryland|Maryland
 Colleges and universities in Mississippi|Mississippi
 Colleges and universities in North Carolina|North Carolina
 Colleges and universities in Oklahoma|Oklahoma
 Colleges and universities in South Carolina|South Carolina
 Colleges and universities in Tennessee|Tennessee
 Colleges and universities in Texas|Texas
 Colleges and universities in Virginia|Virginia
 Colleges and universities in West Virginia|West Virginia

 West 

 Colleges and universities in Alaska|Alaska
 Colleges and universities in Arizona|Arizona
 Colleges and universities in California|California
 Colleges and universities in Colorado|Colorado
 Colleges and universities in Hawaii|Hawaii
 Colleges and universities in Idaho|Idaho
 Colleges and universities in Montana|Montana
 Colleges and universities in Nevada|Nevada
 Colleges and universities in New Mexico|New Mexico
 Colleges and universities in Oregon|Oregon
 Colleges and universities in Utah|Utah
 Colleges and universities in Washington|Washington
 Colleges and universities in Wyoming|Wyoming

 Unincorporated island 

 Colleges and universities in American Samoa|American Samoa
 Colleges and universities in Guam|Guam
 Colleges and universities in the Northern Mariana Islands|Northern Mariana Islands
 Colleges and universities in Puerto Rico|Puerto Rico
 Colleges and universities in the U.S. Virgin Islands|U.S. Virgin Islands




Category:Colleges and universities in the United States| 
Category:Lists of colleges and universities
Category:United States-related lists