

Image:Hankyu Kawara-Machi.jpg|thumb|300px|right|Takashimaya (right) and Hankyu Department Store (center) are connected to Kawaramachi Station
'''Kawaramachi Station''' (河原町駅, ''Kawaramachi eki''Help:Japanese|?) is the terminal station of the Hankyu Kyoto Line of Hankyu Railway in Kyoto, Japan. The Kawaramachi street|Kawaramachi and Shijo streets cross over the underground station.  Keihan Electric Railway|Keihan Shijo Station (Keihan)|Shijo Station is beyond the Kamo River (Kyoto)|Kamo River.

The area around the station is one of the commercial centers of Kyoto. The real estate around the station is the most valuable in Kyoto.

The station is attached underground to department stores such as Takashimaya, which has a food market on its basement floor.  The station also connects underground to Karasuma Station.

The station opened on June 17, 1963. Before the opening of Kawaramachi Station and Karasuma Station, the Hankyu Kyoto Line ended at Ōmiya Station (Kyoto)|Ōmiya Station.




Template:Hankyu Kyoto Line|v&nbsp;•&nbsp;Template talk:Hankyu Kyoto Line|d&nbsp;•&nbsp;Stations of the Hankyu Kyoto Line


Umeda Station|Umeda – 
Jūsō Station|Jūsō –
Minamikata Station (Osaka)|Minamikata –
Sōzenji Station|Sōzenji –
Awaji Station|Awaji –
Kami-Shinjō Station|Kami-Shinjō –
Aikawa Station (Osaka)|Aikawa –
Shōjaku Station|Shōjaku –
Minami-Ibaraki Station|Minami-Ibaraki –
Ibaraki-shi Station|Ibaraki-shi –
Sōjiji Station|Sōjiji –
Tonda Station|Tonda –
Takatsuki-shi Station|Takatsuki-shi –
Kammaki Station|Kammaki –
Minase Station|Minase –
Ōyamazaki Station|Ōyamazaki –
Nagaoka-Tenjin Station|Nagaoka-Tenjin –
Nishi-Mukō Station|Nishi-Mukō –
Higashi-Mukō Station|Higashi-Mukō –
Rakusaiguchi Station|Rakusaiguchi –
Katsura Station|Katsura –
Nishi-Kyōgoku Station|Nishi-Kyōgoku –
Saiin Station|Saiin –
Ōmiya Station (Kyoto)|Ōmiya -
Karasuma Station|Karasuma -
Kawaramachi Station






Category:Railway stations in Kyoto Prefecture