The following is a '''list of rivers of Africa''', by region.

Southern Africa
 Berg River|Berg - South Africa
 Cuanza River|Anzac - Angola
 Fish River, Namibia|Fish - Namibia
 Groot River|Groot - South Africa
 Ihosy River - Madagascar
 Kuiseb River|Kuiseb - Namibia
 Kunene River|Kunene - Angola ''(as Cunene River|Cunene)'', Namibia, Botswana
 Kwando River|Kwando - Namibia, also known as ''Linyanti'' and ''Chobe'' in places
 Limpopo River|Limpopo - Mozambique, South Africa, Zimbabwe, Botswana
 Mangoky River - Madagascar
 Mania River - Madagascar
 Molopo River|Molopo - Botswana, South Africa
 Okavango River|Okavango - Botswana, Namibia, Angola ''(as "Cubango")''
 Onilahy River - Madagascar
 Orange River|Orange - South Africa, Lesotho, Namibia
 Tugela River|Tugela - South Africa
 Vaal River|Vaal - South Africa
 Zambezi - Angola, Zambia, Namibia, Zimbabwe, Mozambique

Central Africa
 Chari River|Chari - Central African Republic, Chad, Cameroon
Logone River|Logone
 Congo River|Congo 
 Kwango River|Kwango
 Kasai River|Kasai
 Lualaba River|Lualaba
 Lomami River|Lomami
 Ubangi River|Ubangi - Democratic Republic of the Congo, Republic of the Congo, Central African Republic ''(as "Oubangui")''
 Uele River|Uele
 Mbomou River|Mbomou
 Gabon River|Gabon
 Kouilou-Niari River|Kouilou-Niari - Congo
 Mbini River|Mbini
 Ntem River|Ntem
 Nyanga River|Nyanga - Gabon
 Ogooué River|Ogooué - Gabon

East Africa
 Awash River|Awash - Ethiopia
 Jubba River|Jubba - Somalia
 Dawa River|Dawa - Ethiopia
 Gebele River|Gebele - Ethiopia
 Kerio - Kenya
 Maputo River|Maputo - Mozambique
 Mara River|Mara - Kenya, Tanzania
 Omo River|Omo - Ethiopia
 Rufiji River|Rufiji - Tanzania
 Ruvuma River|Ruvuma (Rovuma) - Tanzania, Mozambique
 Shebelle River|Shebelle - Ethiopia, Somalia
 Tana River|Tana - Kenya
 Victoria Nile - Uganda
 Albert Nile - Uganda
 Kazinga Channel - Uganda
 Kagera River (Rwanda, Tanzania, Uganda)

West Africa
 Bandama River|Bandama - Côte d'Ivoire
 Cavally River|Cavally - Liberia, Côte d'Ivoire
 Gambia River|Gambia - Gambia, Senegal
 Niger River|Niger - Nigeria, Benin, Niger, Mali, Guinea
 Oueme River|Oueme - Benin
 Saint Paul River|Saint Paul - Liberia
 Sanaga River|Sanaga - Cameroon
 Sankarani river|Sankarani- Mali
 Senegal River|Senegal - Senegal, Mauritania, Mali
 Volta River|Volta - Ghana, Burkina Faso
 Benue - Nigeria

North Africa
 Nile - Egypt, Sudan, Ethiopia
 Atbarah River - Sudan, Ethiopia
 Blue Nile - Sudan, Ethiopia
 Didessa River - Ethiopia
 Mountain Nile - Sudan
 Bahr el Zeraf - Sudan
 White Nile - Sudan

 Bou Regreg - Morocco
 Draa River - Algeria, Morocco
 Moulouya River - Morocco
 Oum Er-Rbia River - Morocco
 Sebou River - Morocco


Category:Lists of rivers of Africa| 