The following is a list of '''rivers of the Americas''', and includes all the major rivers of the Americas:

North America
Alsek River|Alsek - Canada/United States
Colorado River|Colorado - United States / Mexico
Columbia River|Columbia - Canada/United States
Okanagan River|Okanagan - Canada/United States
Kettle River (Columbia River)|Kettle - Canada
Pend Oreille River|Pend Oreille - United States
Kootenay River|Kootenay - Canada/United States
Canoe River|Canoe - Canada
Kicking Horse River|Kicking Horse - Canada
Dean River|Dean - Canada
Fraser River|Fraser - Canada
Pitt River|Pitt - Canada
Thompson River|Thompson - Canada
Chilcotin River|Chilcotin - Canada
Quesnel River|Quesnel - Canada
Nechako River|Nechako - Canada
Liard River|Liard - Canada
Mackenzie River|Mackenzie - Canada
Peace River (Canada)|Peace - Canada
Mississippi River|Mississippi - United States
Missouri River|Missouri -United States
Nass River|Nass - Canada
Ohio River|Ohio - United States
Rio Grande - Mexico/United States
Sacramento River|Sacramento - United States
Saskatchewan River|Saskatchewan - Canada
Skagit River|Skagit - Canada/United States
Skeena River|Skeena - Canada
Babine River|Babine - Canada
Bulkley River|Bulkley - Canada
Morice River|Morice - Canada
Kitwanga River|Kitwanga - Canada
Zymoetz River|Zymoetz - Canada
Squamish River|Squamish - Canada
St. Lawrence River|St. Lawrence - Canada
Yukon River|Yukon - Canada/United States

Central America

Escondido River|Escondido - Nicaragua
Grande de Matagalpa River|Grande de Matagalpa - Nicaragua
Patuca River|Patuca - Honduras
San Juan River (Nicaragua)|San Juan - Nicaragua
Usumacinta - Mexico, Guatemala
Cahabón - Guatemala
Cahaboncito - Guatemala
Lankin - Guatemala
Nahualate - Guatemala
Los Esclavos - Guatemala
Rio Dulce - Guatemala
Reventazón River - Costa Rica
Tárcoles River - Costa Rica
Tempisque River - Costa Rica

South America
Aconcagua River|Aconcagua - Chile
Amazon River|Amazon - Ecuador. Perú, Bolivia, Venezuela, Colombia, Brazil
Madeira river|Madeira - Brazil
Rio Negro (Amazon)|Rio Negro - Venezuela, Colombia, Brazil
Tocantins River|Tocantins - Brazil
Apure River|Apure - Venezuela
Atrato River|Atrato - Colombia
Bío-Bío River|Bío-Bío - Chile
Malleco River|Malleco - Chile
Caroní River (Venezuela)|Caroní - Venezuela
Cautín River|Cautín - Chile
Chubut River|Chubut - Argentina
Colorado River (Argentina)|Colorado - Argentina
Elqui River|Elqui - Chile
Essequibo River|Essequibo - Guyana
Itata River|Itata - Chile
Ñuble River|Ñuble - Chile
Loa River|Loa - Chile
Magdalena River|Magdalena - Colombia
Maipo River|Maipo - Chile
Mapocho River|Mapocho - Chile
Maule River|Maule - Chile
Loncomilla River|Loncomilla - Chile
Achibueno River|Achibueno - Chile
Ancoa River|Ancoa - Chile
Longaví River|Longaví - Chile
Perquilauquén River|Perquilauquén - Chile
Purapel River|Purapel - Chile
Putagán River|Putagán - Chile
Melado River|Melado - Chile
Maullín River|Maullín - Chile
Maroni River|Maroni - Suriname, French Guiana
Orinoco River|Orinoco - Colombia, Venezuela
Apure River|Apure - Venezuela
Arauca River|Arauca - Colombia, Venezuela
Meta River|Meta - Colombia, Venezuela
Guaviare River|Guaviare - Colombia
Parnaiba River|Parnaiba - Brazil
Rapel River|Rapel - Chile
Reñihue River|Reñihue - Chile
Río Bueno River|Río Bueno - Chile
Rahue River|Rahue - Chile
Damas River|Damas - Chile
Río de la Plata It is not really a river but the lower stretch of the Paraná River|Paraná and the estuary that forms after its confluence with the Uruguay River|Uruguay
Paraná River|Paraná - Brazil, Argentina, Paraguay
Uruguay River|Uruguay - Brazil, Argentina, Uruguay
Palena River|Palena - Chile
Petrohué River|Petrohué - Chile
Puelo River|Puelo - Chile
São Francisco River|São Francisco - Brazil
Toltén River|Toltén - Chile
Trancura River|Trancura - Chile
Valdivia River|Valdivia - Chile
Calle-Calle River|Calle-Calle - Chile
San Pedro River, Chile|San Pedro - Chile
Enco River|Enco - Chile
Llanquihue River|Llanquihue - Chile
Huahum River|Huahum - Chile, Argentina
Chapelco River|Chapelco - Argentina
Liquiñe River|Liquiñe - Chile 
Cau-Cau River|Cau-Cau - Chile
Cruces River|Cruces - Chile
Cutipay River|Cutipay - Chile
Futa River|Futa - Chile
Yelcho River|Yelcho - Chile
Futaleufú River|Futaleufú - Chile

Category:Lists of rivers of North America| 
Category:Lists of rivers of South America| 