
 0-9 
 2D - Two dimensions
 3-D|3D - Three dimensions
 4WD - Four-wheel drive

 A 

 B 
 BASIC - '''B'''eginners '''A'''ll-purpose '''S'''ymbolic '''I'''nstruction '''C'''ode
 BIOS - Basic Input/Output System

 C 
CCTV - Closed-circuit television, China Central Television, Cork Community TV
Compact disc|CD - Compact Disk
CD-ROM - Compact Disk - Read Only Memory
COBOL - Common Business-Orientated Language
CIA - Central Intelligence Agency
Central processing unit|CPU - '''C'''entral '''P'''rocessing '''U'''nit

 D 
 DVD - Digital Versatile Disc and Digital Video Disc

 E 
E3 - Electronic Entertainment Expo
ESPN - Entertainment and Sports Programming Network

 F 
FTP - File Transfer Protocol
FPS - First Person Shooter, Frames Per Second
FORTRAN - FORmula TRANslator
FBI - Federal Bureau of Investigation

H
HTTP - Hyper Text Transport Protocol
HTTPS - Hypertext Transfer Protocol Secure

 I 
Internet - '''Inter'''connected '''Net'''works

 L 
LASER - '''L'''ight '''A'''mplification by '''S'''timulated '''E'''mission of '''R'''adiation

 M 
Maser - '''M'''olecular '''A'''mplification by '''S'''timulated '''E'''mission of '''R'''adiations
MMORPG - Massively Multiplayer Online Role Playing Game
MOSFET - '''M'''etal '''O'''xide '''S'''emiconductor '''F'''ield '''E'''ffect '''T'''ransistor

 N 
NAFTA -  '''N'''orth '''A'''merican '''F'''ree '''T'''rade '''A'''greement
NASA -  '''N'''ational '''A'''eronautics and '''S'''pace '''A'''dministration

P
Perl - Practical Extraction and Report Language
PHP - PHP: Hypertext Preprocessor
POP - Post Office Protocol
POSH - Port Out, Starboard Home

R
Radar - Radio detection and ranging
RAM - Random Access Memory
ROM - Read Only Memory
Role-playing game|RPG - Role Playing Game
RTFM - Read The Fine ( or Flippin' ) Manual
RTS - Real Time Strategy

 S 
SCUBA - Self Contained Underwater Breathing Apparatus
Sitcom/SITCOM - '''SIT'''uation '''COM'''edy
Stock-Keeping Unit|SKU - Stock Keeping Unit (bar code on products)
SMTP - Simple Mail Transfer Protocol
Sonar - Sound navigation and ranging
SWAT - Special Weapons And Tactics

 T 
 TBS - Turn-Based Strategy
 TV - Television
TNA - Total Nonstop Action

 U 
USB - Universal Serial Bus

W
W3C - '''W'''orld '''W'''ide '''W'''eb '''C'''onsortium
WWW - World Wide Web
WWE - World Wrestling Entertainment
WWF - World Wrestling Federation

 X 
XWD - Cross Wheel Drive


Category:Acronyms|
Category:Lists