The following is a '''list of the major rivers of Asia''', by letter. See the articles for tributaries and other information.

 Amu Darya - Turkmenistan, Uzbekistan - Aral Sea
 Amur River|Amur - China (Manchuria), Russia (Siberia) - Sea of Okhotsk
 Angara River|Angara
 Araks River|Aras -Turkey
 Buriganga River - Bangladesh
 Büyük Menderes River|Büyük Menderes( Maeander) - Turkey
 Brahmaputra - China (Tibet), India (Assam), Bangladesh - Bay of Bengal
 Cagayan River|Cagayan - Philippines (Luzon)
 Chao Phraya - Thailand - Gulf of Thailand
 Dicle River|DicleTigris - Turkey, Iraq 
 Fırat River|Fırat Euphrates - Turkey, Syria, Iraq
 Ganges River - India
 Ghaggar River
 Godavari River|Godavari - India
 Habur river|Habur (Khabur) Turkey, Syria
 Hai River|Hai - China - Yellow Sea
 Han River (Korea)|Han River - Korea - Yellow Sea
 Hari River, Afghanistan - Afghanistan and Turkministan
 Huai River|Huai - China - Yellow Sea
 Huangpu River - China
 Indus River|Indus - China (Tibet), Pakistan
 Ayeyarwady River - Burma
 Irtysh - China
 Jordan River|Jordan - Israel, Jordan
 Kapuas River|Kapuas - Borneo
 Karakash River|Karakash - China (Takla Makan)
 Karnaphuli River|Karnaphuli - India, Bangladesh
 Karun Iran
 Kaveri River- India
 Kızılırmak Halys River|Halys - Turkey
 Krishna River|Krishna - India - Bay of Bengal
 Kolyma River|Kolyma - Russia (Siberia)
 Küçük Menderes (Cayster) - Turkey
 Lena River|Lena - Russia (Siberia)
 Lishui River|Lishui (Li)- China
 Liao River|Liao - China (Manchuria) - Bohai Gulf
 Marikina River - Philippines (Marikina City, Metro Manila)
 Mekong - China, Laos, Myanmar, Thailand, Vietnam, Cambodia.
 Mindanao River|Mindanao - Philippines
 Ob River|Ob - Russia (Siberia) - Gulf of Ob of the Arctic Ocean
 Om River|Om - Russia
 Orontes River|Orontes ('Asi) - Lebanon, Syria
 Pasig River - Philippines (Pasig City and Manila, Metro Manila)
 Pearl River (China)|Pearl River - China - South China Sea
 Lijiang River|Lijiang
 Rajang River - Malaysia - South China Sea
 Red River (Vietnam)|Red River - China, Vietnam - South China Sea
 Sakarya River - Turkey
 Salween River|Salween - China (Tibet, Yunnan), Myanmar, Thailand - Andaman Sea
 Sefid River Iran
 Selenga River|Selenga - Russia (Siberia), Mongolia
 Shatt al-Arab - Iraq, Iran - Persian Gulf
 Songhua River|Songhua - China (Manchuria), Russia (Siberia)
 Syr Darya - Kazakhstan
 Tumen River - China, North Korea, Russia - Sea of Japan
 Vaigai River - India
 Xi River|Xi - China
 Xiang River|Xiang - China
 Yangtze River|Yangtze (Chang Jiang) - China - East China Sea
 Yalu River|Yalu - North Korea, China - Korea Bay of the Yellow Sea
 Yellow River (Huang He) - China - Yellow Sea
 Yenisei River|Yenisei - Russia (Siberia)
 Yeşil River|Yeşilırmak -Turkey
 Yuan River|Yuan- China
 Yurungkash - China (Takla Makan)
 Zijiang River|Zijiang (Zi)- China
 Zeravshan - Tajikistan, Uzbekistan


Category:Lists of rivers of Asia| 