The following is a '''list of rivers in China''', by where they flow into:

Arabian Sea
 Indus River|Indus (印度河)

Bay of Bengal
 Yarlung Tsangpo River (Tibet)|Yarlung Tsangpo River (Brahmaputra) (雅鲁藏布江) (joins the Ganges) The Yarlung Tsangpo River flows entirely through Tibet (currently under Chinese administration) and the Indian subcontinent.

Andaman Sea
 Salween River|Salween (萨尔温江 or 怒江)

South China Sea
 Mekong (湄公河)
 Red River (Vietnam) (红河, a.k.a. 元江)
 Pearl River (China)|Pearl River (Zhu Jiang) (珠江)
 Beijiang River|Beijiang (Bei) (北江)
 Dongjiang River|Dongjiang (Dong) (东江)
 Han River (Guangdong)|Han (韩江)
 Mei River|Mei (梅江)
 Ning River|Ning (宁江)
 Ting River|Ting (汀江)
 Dajing River|Dajing (大靖河)  
 Xijiang River|Xijiang (Xi) (西江)
 Yujiang River|Yujiang (Yu) (鬱江)
 Yongjiang (Yong) (邕江）)
 Zuojiang River|Zuojiang (Zuo) (左江)
 Youjiang River|Youjiang (You) (右江)
 Xunjiang (Xun) (浔江）
 Qianjiang River|Qiangjiang (Qiang) (黔江)
 Rongjiang (Rong)（融江）
 Hongshui River|Hongshui (Red River) (红水河）
 Beipan River|Beipan (北盘江)
 Nanpan River|Nanpan (南盘江)
 Ba River (China)|Ba (灞水 or 灞河)
 Guijiang River|Guijiang (Gui) (桂江)
 Lijiang River|Lijiang (Li) (漓江)

Taiwan Strait
 Minjiang River (Fujian)|Min (Fujian) (闽江)

East China Sea
 Qiantang River, Qian River (钱塘江 or 钱江, upper reach known as 新安江)
 Huangpu River (黃浦江)
 Yangtze River (Chang Jiang) (长江, upper reach known as 金沙江)
 Tongtian River
 Yalong River (雅砻江）
 Min River (Sichuan)|Min (Sichuan) (岷江)
 Wu River, Guizhou|Wu (乌江）
 Jialing River|Jialing (嘉陵江)
 Bailong River|Bailong (白龙江)
 Baishui River|Baishui (白水)
 Qu River|Qujiang (渠江)
 Fu River|Fujiang (涪江)
 Xiang River|Xiang (湘江)
 Xiao River|Xiaoshui (瀟水)
 Zheng River|Zhengshui (蒸水)
 Lishui River|Lishui (Li) (澧水)
 Yuanjiang River|Yuanjiang (Yuan) (沅江)
 Wu River, Hunan|Wu River (巫水)
 Zijiang River|Zijiang (Zi) (资江)
 Han River|Hanshui  (汉江 or 汉水)
 Gan River|Gan (赣江)
 Zhang River|Zhang (章江)
 Gong River|Gongshui (貢水)
 Mei River|Mei (梅河)
 Xiang River (Jiangxi)|Xiang (Jiangxi) (湘水)

Yellow Sea
 Huai River|Huai (淮河)
 Shaying River|Shaying (沙颖河)
 Yi River|Yi (沂河)
 Shu River|Shu (沭河)
 Si River|Si (泗河)
 Jiao River|Jiao (胶河)
 Yalu River|Yalu (鸭绿江) - Korea Bay

Bohai Sea
 Wei River (Shandong)|Wei (潍河) 
 Xiaoqing River|Xiaoqing (小清河, formerly known as 济河) 
 Yellow River (Huang He) (黃河) 
 Daxia River|Daxia (大峡河)
 Fen River|Fen (汾河)
 Wei River|Wei (渭河)
 Jing River|Jing (泾河)
 Luo River|Luo (洛河)
 Hai River|Hai (海河) 
 Wei River (Hebei)|Wei (卫河)
 Zhang River (Shanxi)|Zhang (漳河)
 Yongding River|Yongding (永定河)
 Luan River|Luan (滦河) 
 Liao River|Liao (辽河)

Sea of Japan
 Tumen River (图们江)
 Amur|Heilong Jiang (Heilongjiang) (黑龙江)
 Songhua River (松花江)

Arctic Ocean
 Irtysh River|Irtysh (额尔齐斯河) - Gulf of Ob (joins Ob River)

Canals
Grand Canal of China (大运河)

Rivers that do not flow into any larger body of water
 Muzat River - tributary of the Tarim River
 Tarim River - ends in the Taklamakan Desert
 Ili river - ends in Lake Balkhash
 Karakash River|Karakash (Black Jade River) (黑玉江) - ends in the Taklamakan Desert
 Yurungkash River|Yurungkash (White Jade River) (白玉江) - ends in the Taklamakan Desert
Category:Rivers of China|