The '''London station group''' is a group of 18 railway stations in central London. They are part of the National Rail network. Most are Train station#Terminus|terminal stations, meaning that they are at the end of the railway line. The station group is shown on tickets as ''London Terminals''.

Group members

As of , the group is made up of:


Blackfriars station|Blackfriars
Cannon Street station|Cannon Street
Charing Cross railway station|Charing Cross
City Thameslink railway station|City Thameslink
Euston railway station|Euston
Fenchurch Street railway station|Fenchurch Street
London King's Cross railway station|King's Cross
Liverpool Street station|Liverpool Street
London Bridge station|London Bridge
Marylebone station|Marylebone
Moorgate station|Moorgate
Old Street station|Old Street
London Paddington station|Paddington
St Pancras railway station|St. Pancras International
Vauxhall station|Vauxhall
London Victoria station|Victoria
London Waterloo station|Waterloo
London Waterloo East railway station|Waterloo East


Former members
Broad Street railway station (London)|Broad Street (closed 1986)
Holborn Viaduct railway station|Holborn Viaduct (closed 1990)
Kensington (Olympia) station|Kensington Olympia (withdrawn 1994)
King's Cross Thameslink railway station |Kings Cross Thameslink (closed 2007)

Station statistics 


Related pages
List of London railway stations

Footnotes
 for Thameslink from the north only
 for Thameslink from the south only
 does not include London Underground
 from 2008/2009, King's Cross Thameslink passengers are grouped with St Pancras. In addition, full Eurostar services began from St Pancras on 9 December 2007.

Category:Railway stations in London|